################################################################################################
#..............................................................................................#
#....E.............E.................E.................E.......................................#
#..............................................................................................#
#...........#####.............#####.............#####..........................................#
#..............................................................................................#
#......................E..................E..................E..................................#
#..............................................................................................#
#.....#####.......................#####.......................#####............................#
#..............................................................................................#
#.........................C....................................................................#
#..............................................................................................#
#........E.........................E.........................E..................................#
#..............................................................................................#
#....P.........................................................................................#
################################################################################################