################################################################################################
#..............................................................................................#
#..............................................................................................#
#..............................................................................................#
#....................#####.....................B.............................#####.............#
#..............................................................................................#
#..............................................................................................#
#..............................................................................................#
#..............................................................................................#
#..............................................................................................#
#.........................#####.....................................#####......................#
#..............................................................................................#
#..............................................................................................#
#..............................................................................................#
#..............................................................................................#
#....P.....................................................................................D...#
#....###.........................#####.........................#####.........................####
################################################################################################